[
  {
    "type": "overmap_special",
    "id": "Evac Shelter JK",
    "overmaps": [
      { "point": [ 0, 0, 0 ], "overmap": "shelter_jk_north" },
      { "point": [ 0, 0, -1 ], "overmap": "shelter_under_north" },
      { "point": [ 0, 0, 1 ], "overmap": "shelter_roof_north" }
    ],
    "connections": [ { "point": [ 0, -1, 0 ], "terrain": "road", "connection": "local_road", "from": [ 0, 0, 0 ] } ],
    "locations": [ "wilderness" ],
    "city_distance": [ 3, 10 ],
    "city_sizes": [ 4, -1 ],
    "occurrences": [ 90, 100 ],
    "flags": [ "UNIQUE", "CLASSIC", "URBAN" ]
  },
  {
    "type": "overmap_terrain",
    "id": [ "shelter_jk" ],
    "name": "evac shelter J-K23",
    "sym": "+",
    "color": "white",
    "see_cost": 2,
    "flags": [ "KNOWN_DOWN", "SOURCE_PEOPLE", "SOURCE_SAFETY" ]
  },
  {
    "id": "shelter_supplies",
    "type": "item_group",
    "subtype": "collection",
    "//": "now used for shelters that have been looted by kids, see SUS groups for general shelter supplies",
    "items": [
      [ "wrapper", 90 ],
      [ "evac_pamphlet", 80 ],
      [ "glass_shard", 80 ],
      [ "emer_blanket", 40 ],
      [ "bottle_plastic", 30 ],
      [ "plastic_knife", 20 ],
      [ "plastic_spoon", 20 ],
      [ "plastic_fork", 20 ],
      [ "bowl_plastic", 10 ],
      [ "jacket_evac", 15 ],
      [ "folding_poncho", 10 ],
      [ "sponge", 10 ],
      [ "mask_dust", 9 ],
      [ "handflare_dead", 9 ],
      [ "whistle", 7 ],
      [ "teddy_bear", 7 ],
      { "item": "vinegar", "prob": 6, "charges-min": 1 },
      [ "candle", 5 ],
      [ "pliers", 4 ],
      [ "mirror", 4 ],
      [ "wearable_light", 2 ],
      [ "calcium_tablet", 1 ],
      [ "vitamins", 1 ],
      { "item": "protein_bar_evac", "count": [ 0, 3 ] }
    ]
  },
  {
    "type": "mapgen",
    "method": "json",
    "weight": 100,
    "om_terrain": [ "shelter_jk" ],
    "object": {
      "fill_ter": "t_floor",
      "rows": [
        "    !!!!!!!!!!!!!!!!    ",
        "    `!!!!`!!!!`!!!!`    ",
        "    `!!!!`!!!!`!!!!`    ",
        "    `!!!!`!!!!`!!!!`    ",
        "    `!!!!`!!!!`!!!!`    ",
        "    `!!!!`!!!!`!!!!`    ",
        "    `!!!!`!!!!`!!!!`    ",
        "    &&&&&&&&&&&&&&&&    ",
        "    |----:-++-:----|    ",
        "    |.............6|    ",
        "    |..............|    ",
        "    |..............|    ",
        "    |..............|    ",
        "    :..............:    ",
        "    |..............|    ",
        "    |......>>......|    ",
        "    |......>>......|    ",
        "    |..............|    ",
        "    :..............:    ",
        "    |..............|    ",
        "    |..............|    ",
        "    |||............|    ",
        "    |*=...........6|    ",
        "    |----:--+-:----|4   "
      ],
      "palettes": [ "shelter" ],
      "place_nested": [ { "chunks": [ [ "shelter_nest_base", 100 ] ], "x": 0, "y": 0 },
                        { "chunks": [ [ "jk_spawn", 100 ], [ "null", 0 ] ], "x": 12, "y": 15 },
                        { "chunks": [ [ "jk_spawn", 100 ], [ "null", 0 ] ], "x": 13, "y": 15 },
                        { "chunks": [ [ "jk_spawn", 100 ], [ "null", 0 ] ], "x": 14, "y": 15 },
                        { "chunks": [ [ "jk_spawn", 100 ], [ "null", 0 ] ], "x": 15, "y": 15 },
                        { "chunks": [ [ "jk_spawn", 100 ], [ "null", 0 ] ], "x": 12, "y": 14 },
                        { "chunks": [ [ "jk_spawn", 100 ], [ "null", 0 ] ], "x": 12, "y": 13 },
                        { "chunks": [ [ "jk_spawn", 100 ], [ "null", 0 ] ], "x": 12, "y": 12 },
                        { "chunks": [ [ "jk_spawn", 100 ], [ "null", 0 ] ], "x": 12, "y": 11 }
                      ]
    }
  }
]
